100000000000000001
200000000000000002
300000000000000003
400000000000000004
500000000000000005
600000000000000006
700000000000000007
800000000000000008
